NO ./textures/wall.xpm
SO ./textures/wall.xpm
EA ./textures/wall.xpm
WE ./textures/wall.xpm
F 100,80,60
C 50,120,200

111111111111111111111111
100000000000000000000001
100000000000000000000001
100000000000000000000001
100000110000000000000001
100000110000000000000001
100000000000000000000001
1000000000000000N0000001
100000000000000000000001
100000000000000000000001
100000000110000000000001
100000000110000000000001
100000000000000000000001
100000000000000000000001
111111111111111111111111
